XXXXXXXXXXXXXXXXXXXXXXXXXXXXXXXXXXXXXXXX
X-OX-----MVV---VV----V-V-----------XXCXX
X--X----V--------------------------XX-XX
X--X-------------V-----------------XX-XX
X--X--------XXXXXXXXXXX--XXXXXXXXXXXX-XX
X--X--VV----X------------X-----V---XX-XX
X--X--------XV-X-XXXXXXXXX--X-X-X--XX-XX
X--X--------X--------V------X------XX-XX
X---VV------X-M-V-----------XV--------XX
XXXXXXXXXXXXXXXXXXXXXXXXXXXXXXXXXXXXXXXX