XXXXXXXXXXXXXXXXXXXXXXXXXXXXXXXXXXXXXXXX
X----------V--H-----V------V------V--CCX
X---------------------------MH-------CCX
X---------M---H----------------------CCX
X------V----------O----H-V------V----CCX
X----M-----H-----------------H--M----CCX
X------------V--------V------V-------CCX
X-----------------M------------------CCX
X----H------------------H------------CCX
XXXXXXXXXXXXXXXXXXXXXXXXXXXXXXXXXXXXXXXX