XXXXXXXXXXXXXXXXXXXXXXXXXXXXXXXXXXXXXXXX
XXXXXXXXXXXXXXXXXXXXXXXXXXXXXXXXXXXXXXXX
X-V--------M-------H--------------CCCXXX
X---------------M---------H-------CCCXXX
X---VXXXXXXXXXXXXXXXXXXXXXXXXXXXXXXXXXXX
X---------H--M--------------H-------MXXX
XV------------------H-------M----V-V-XXX
XXXXXXXXXXXXXXXXXXXXXXXXXXXXXXXX----MXXX
XH-------O------------------------V--XXX
XXXXXXXXXXXXXXXXXXXXXXXXXXXXXXXXXXXXXXXX