XXXXXXXXXXXXXXXXXXXXXXXXXXXXXXXXXXXXXXXX
X-OX------VV---VV----V-V-----------XCCXX
X--X----V--------------------------XCCXX
XMMX-------------V-----------------XCCXX
X--X--------XXXXXXXXXXX--XXXXXXXXXXXCCXX
X-CX--VV----X------------X-----V---XCCXX
X--X--------XV-X-XXXXXXXXX--X-X-X--XCCXX
X--X--------X---------------X------XCCXX
X---VV------X---V-----------XV--------XX
XXXXXXXXXXXXXXXXXXXXXXXXXXXXXXXXXXXXXXXX