XXXXXXXXXXXXXXXXXXXXXXXXXXXXXXXXXXXXXXXX
X-OX------VV---VV----V-V-----------XXCXX
X--X----V------------H-------------XX-XX
X--X-------------V-----------------XX-XX
XM-X--------XXXXXXXXXXX--XXXXXXXXXXXX-XX
XM-X--VV----X------------X-----V---XX-XX
X--X--------XV-X-XXXXXXXXX--X-X-X--XX-XX
XC-X--------X---------------X------XX-XX
X---VV------X---V-----------XV--------XX
XXXXXXXXXXXXXXXXXXXXXXXXXXXXXXXXXXXXXXXX