XXXXXXXXXXXXXXXXXXXXXXXXXXXXXXXXXXXXXXXX
X-OX-----MVV---VV----V-V-----------XCCXX
X--X----V--------------------------XCCXX
X--X-------------V-----------------XCCXX
X--X--------XXXXXXXXXXX--XXXXXXXXXXXCCXX
X--X--VV----X------------X-----V---XCCXX
X--X--------XV-X-XXXXXXXXX--X-X-X--XCCXX
X--X--------X--------V------X------XCCXX
X---VV------X-M-V-----------XV--------XX
XXXXXXXXXXXXXXXXXXXXXXXXXXXXXXXXXXXXXXXX