XXXXXXXXXXXXXXXXXXXXXXXXXXXXXXXXXXXXXXXX
X-OX-----MVVM--VV----V-V-----------XCCXX
X--X----V--------------------------XCCXX
X--X---------C---V-----------------XCCXX
X--X--------XXXXXXXXXXX--XXXXXXXXXXXCCXX
X--X--VV----X------------X-----V---XCCXX
X--X--------XV-X-XXXXXXXXX--X-X-X--XCCXX
X--X--------X---------------X------XCCXX
X---VV------X---V-----------XV--------XX
XXXXXXXXXXXXXXXXXXXXXXXXXXXXXXXXXXXXXXXX